####################
#...#..............#
#..................#
######.............#
#..................#
#..................#
#..................#
#..................#
#..................#
#........@.........#
#..................#
#..................#
#..................#
#..................#
#..................#
#..................#
#..................#
#..................#
#..................#
####################
