##########
#.W...####
#####.####
#C#...####
#.#.#...L#
#.#..#...#
#...######
##.@.....#
#..####..#
##########